20 21 21 21 21 21 21 21 21 21 21 21 21 21 21 21 21 21 21 21 21 21 21 21 21 21 21 21 21 22
27 6 6 6 6 6 6 6 6 6 6 6 6 6 6 6 6 6 6 6 6 6 6 6 6 6 6 6 6 23
27 6 6 6 6 6 10 12 6 6 6 6 6 6 6 6 6 6 6 6 6 6 6 6 6 6 6 7 6 23
27 6 6 7 6 6 16 18 12 6 6 6 7 6 6 6 6 6 2 0 0 3 6 6 6 6 6 6 6 23
27 6 6 6 6 6 6 16 14 6 6 6 6 6 6 6 6 6 1 6 6 1 6 6 6 6 6 6 6 23
27 6 6 6 6 6 6 6 6 6 6 6 6 6 6 6 6 6 1 6 6 1 6 6 6 6 8 8 8 23
28 0 0 0 3 6 6 6 6 6 6 6 6 6 2 0 0 0 4 6 6 5 0 0 0 0 8 8 8 23
27 6 6 6 1 6 6 6 6 7 6 6 6 6 1 6 6 6 6 6 6 6 6 6 6 6 8 8 8 23
27 6 6 6 1 6 6 6 6 6 6 6 6 6 1 6 6 6 6 6 6 6 6 6 6 6 6 6 6 23
27 6 6 6 1 6 6 6 6 6 6 6 6 6 1 6 6 6 6 7 6 6 6 10 11 12 6 6 6 23
27 6 6 6 5 0 0 0 0 0 0 0 0 0 4 6 6 6 6 6 6 6 6 16 18 13 6 6 6 23
27 6 7 6 6 6 6 6 6 6 6 6 6 6 6 6 6 6 6 6 6 6 6 6 16 14 6 6 6 23
27 6 6 6 6 6 6 6 6 6 6 6 6 6 6 6 6 6 6 6 6 6 6 6 6 6 6 6 6 23 
26 25 25 25 25 25 25 25 25 25 25 25 25 25 25 25 25 25 25 25 25 25 25 25 25 25 25 25 25 24
